32,18 
5,0
31,16
XXXXX0XXXXXXXXXXXXXXXXXXXXXXXXXX
XX0XX0XXXXXX0000X0XXX0000000000X
XX00000000000XX00000XXX0XXXX0X0X
XXXXXXXXX0XX0XXXX0XXXXX0XXXX0X0X
XXXX000000XX0XX0XXX00000000XXX0X
XXXX0XXXXXX00000XX00XX0XXX0XXX0X
XX00000XXXXXXX0XXXXXXXXX000XXX0X
XXX0XX0XX0XXXXXXXXX0XX000XXXXXXX
XX00XX0XX00X000XXXX0000XXXXXXXXX
XXXXX00000XX0XXXXXX0XX0000XXXXXX
XXXXXXXX0XXX00XX0000XXXX0XX00XXX
XXXXXX0000000XXXXXX0XXXX0XX0XXXX
XXXXXXXXXXXX0XXXXXX0XXXX0000XXXX
XXXXXXXXXX000XX0XXX0XXXXX0XXXXXX
XXXXXXXXXX0XXXX00000XXX0000000XX
XXXXXXXXXX0XX000XXXXX0XXXX0XX00X
XXXXXXXXXX0000XXXXXXX000000XXX00
XXXXXXXXXXXXXXXXXXXXXXXXXXXXXXXX

